..##.....T
#H##..###.
#.###E###E
#E....###.
###T#####G
